101010101111010
010101011010101
000001000100010
010100010001001
010101110000000
000000000001000
010101000010001
001000100000001
010000010000001
000000010010001
001010111010001
010010101010000
010101011100000
001111000101000
001011110001000